####.###..
#S....#...
#####.##..
..........
##.####..#
#..#.....#
..##F####.
