##########
#S  # #  #
### # ## #
#   #    #
##    #  #
#  # ### #
####  ####
##### ####
#     #  F
### #### #
#   #    #
##    #  #
#  # ### #
##########