##########
#S  # #  F
### # ## #
#   #    #
##    #  #
#  # ### #
##########