#### ###
#S    #
##### ##
         
## ####  #
#  #     #
  ##F####
